************
*          *
*          *
*          *
*          *
*          *
*          *
*          *
*          *
*       G  *
*          *
************
